{   
    "0": ["S           ",
          "            ",
          "            ",
          "        A   ",
          "        A   ",
          "        A   ",
          "        A   ",
          "        A   ",
          "        A   ",
          "        A   ",
          "        A   ",
          "            "],
    
    "1": ["S     F     ",
          "            ",
          "    F  FA   ",
          "       FA   ",
          "    F  FA   ",
          "     F FA   ",
          "  F     A   ",
          "            "],
    
    "2": ["S     RK    ",
          "            ",
          "        A   ",
          "    R       ",
          "      R A   ",
          "   R    C   ",
          "   A        ",
          "            "],
    
    "3": ["S           ",
          "            ",
          "R R R       ",
          "  K R   A   ",
          "        A   ",
          "  FF  F     ",
          "   C    A   ",
          "            "],
    
    "4": ["S           ",
          "            ",
          "    M       ",
          "        A   ",
          "            ",
          "        A   ",
          "            ",
          "            "],
    
    "5": ["SK          ",
          "  M         ",
          "R R R   A   ",
          "  M K       ",
          "R R R   C   ",
          "    M   C   ",
          "        A   ",
          "            "],

    "6": ["S           ",
          "RRRRRR      ",
          "     R  A   ",
          "  K  R      ",
          "  R  R  A   ",
          "  R  RRRR   ",
          "  C         ",
          "            "]
}