{   
    "0": ["S           ",
          "            ",
          "            ",
          "        A   ",
          "        A   ",
          "        A   ",
          "        A   ",
          "        A   ",
          "        A   ",
          "            ",
          "            ",
          "            "],
    
    "1": ["S           ",
          "            ",
          "    FFF     ",
          "    F   A   ",
          "    F   A   ",
          "   FF   A   ",
          "        A   ",
          "        A   ",
          "    F   A   ",
          "    F       ",
          "    FFFFF   ",
          "            "],
    
    "2": ["S     RK    ",
          "     RR     ",
          "            ",
          "    R   A   ",
          "    R   A   ",
          "    RC  A   ",
          "    RR  A   ",
          "    R   A   ",
          "    R   A   ",
          "    RR      ",
          "            ",
          "            "],
    
    "3": ["S           ",
          "            ",
          "R R         ",
          "  K         ",
          "       RR   ",
          "        A   ",
          "   CR   A   ",
          "    R   A   ",
          "    R   A   ",
          "        A   ",
          "        A   ",
          "            "],
    
    "4": ["S           ",
          "            ",
          "    M       ",
          "            ",
          "        A   ",
          "        A   ",
          "        A   ",
          "        A   ",
          "        A   ",
          "        A   ",
          "            ",
          "            "],
    
    "5": ["S           ",
          "  RRRK      ",
          "            ",
          "  M R       ",
          "    R       ",
          "        A   ",
          "        A   ",
          "   M    A   ",
          "        A   ",
          "        A   ",
          "C       A   ",
          "            "],

    "6": ["S           ",
          "            ",
          "            ",
          "  KRRR      ",
          "    R   A   ",
          "    R   A   ",
          "    R   A   ",
          "        A   ",
          "        A   ",
          "     C  A   ",
          "            ",
          "            "]
}